__0_______________________________________________
_XXXXXXXXXXXX_XXXXXXXXXXXX_XXX_XXXXXXXXXXXX_XXXXX_
_XXXXXXXXXXXX_XXXXXXXXXXXX_XXX_XXXXXXXXXXXX_XXXXX_
_XXXXXXXXXXXX_XXXXXXXXXXXX_XXX_XXXXXXXXXXXX_XXXXX_
_XXXXXXXXXXXX_XXXXXXXXXXXX_XXX_XXXXXXXXXXXX_XXXXX_
_______________________________XXXXXXXXXXXX_XXXXX_
_XXXXXXXXXXXX_XXXXXXXXXXXXXXXX_XXXXXXXXXXXX_XXXXX_
_XXXXXXXXXXXX_XXXXXXXXXXXXXXXX_XXXXXXXXXXXX_XXXXX_
_XXXXXXXXXXXX_XXXXXXXXXXXXXXXX_XXXXXXXXXXXX_XXXXX_
_XXXXXXXXXXXX_XXXXXXXXXXXXXXXX_XXXXXXXXXXXX_XXXXX_
__________________________________________________
_XXXXXXXXXXXXXXXXXX_XXXXXXXXXXXX_XXXXXXXXXX_XXXXX_
_XXXXXXXXXXXXXXXXXX_XXXXXXXXXXXX_XXXXXXXXXX_XXXXX_
_XXXXXXXXXXXXXXXXXX_XXXXXXXXXXXX_XXXXXXXXXX_XXXXX_
_XXXXXXXXXXXXXXXXXX_XXXXXXXXXXXX_XXXXXXXXXX_XXXXX_
__________________________________________________
_XXXXXXXXXXXX_XXXXXXXXXXXX_XXX_XXXXXXXXXXXX_XXXXX_
_XXXXXXXXXXXX_XXXXXXXXXXXX_XXX_XXXXXXXXXXXX_XXXXX_
_XXXXXXXXXXXX_XXXXXXXXXXXX_XXX_XXXXXXXXXXXX_XXXXX_
_XXXXXXXXXXXX_XXXXXXXXXXXX_XXX_XXXXXXXXXXXX_XXXXX_
_______________________________XXXXXXXXXXXX_XXXXX_
_XXXXXXXXXXXX_XXXXXXXXXXXXXXXX_XXXXXXXXXXXX_XXXXX_
_XXXXXXXXXXXX_XXXXXXXXXXXXXXXX_XXXXXXXXXXXX_XXXXX_
_XXXXXXXXXXXX_XXXXXXXXXXXXXXXX_XXXXXXXXXXXX_XXXXX_
_XXXXXXXXXXXX_XXXXXXXXXXXXXXXX_XXXXXXXXXXXX_XXXXX_
__________________________________________________
_XXXXXXXXXXXXXXXXXX_XXXXXXXXXXXX_XXXXXXXXXX_XXXXX_
_XXXXXXXXXXXXXXXXXX_XXXXXXXXXXXX_XXXXXXXXXX_XXXXX_
_XXXXXXXXXXXXXXXXXX_XXXXXXXXXXXX_XXXXXXXXXX_XXXXX_
_XXXXXXXXXXXXXXXXXX_XXXXXXXXXXXX_XXXXXXXXXX_XXXXX_
__________________________________________________
_XXXXXXXXXXXX_XXXXXXXXXXXX_XXX_XXXXXXXXXXXX_XXXXX_
_XXXXXXXXXXXX_XXXXXXXXXXXX_XXX_XXXXXXXXXXXX_XXXXX_
_XXXXXXXXXXXX_XXXXXXXXXXXX_XXX_XXXXXXXXXXXX_XXXXX_
_XXXXXXXXXXXX_XXXXXXXXXXXX_XXX_XXXXXXXXXXXX_XXXXX_
_______________________________XXXXXXXXXXXX_XXXXX_
_XXXXXXXXXXXX_XXXXXXXXXXXXXXXX_XXXXXXXXXXXX_XXXXX_
_XXXXXXXXXXXX_XXXXXXXXXXXXXXXX_XXXXXXXXXXXX_XXXXX_
_XXXXXXXXXXXX_XXXXXXXXXXXXXXXX_XXXXXXXXXXXX_XXXXX_
_XXXXXXXXXXXX_XXXXXXXXXXXXXXXX_XXXXXXXXXXXX_XXXXX_
__________________________________________________
_XXXXXXXXXXXXXXXXXX_XXXXXXXXXXXX_XXXXXXXXXX_XXXXX_
_XXXXXXXXXXXXXXXXXX_XXXXXXXXXXXX_XXXXXXXXXX_XXXXX_
_XXXXXXXXXXXXXXXXXX_XXXXXXXXXXXX_XXXXXXXXXX_XXXXX_
_XXXXXXXXXXXXXXXXXX_XXXXXXXXXXXX_XXXXXXXXXX_XXXXX_
__________________________________________________
_XXXXXXXXXXXX_XXXXXXXXXXXX_XXX_XXXXXXXXXXXX_XXXXX_
_XXXXXXXXXXXX_XXXXXXXXXXXX_XXX_XXXXXXXXXXXX_XXXXX_
__________________________________________________