__________0________________________________________
_XXXXXXXXXXXX1XXXXXXXXXXXX_XXX_XXXXXXXXXXXX_XXXXXX_
_XXXXXXXXXXXX_XXXXXXXXXXXX_XXX_XXXXXXXXXXXX_XXXXXX_
_XXXXXXXXXXXX_XXXXXXXXXXXX_XXX_XXXXXXXXXXXX_XXXXXX_
_XXXXXXXXXXXX_XXXXXXXXXXXX_XXX_XXXXXXXXXXXX_XXXXXX_
_______________________________XXXXXXXXXXXX_XXXXXX_
_XXXXXXXXXXXX_XXXXXXXXXXXXXXXX_XXXXXXXXXXXX_XXXXXX_
_XXXXXXXXXXXX_XXXXXXXXXXXXXXXX_XXXXXXXXXXXX_XXXXXX_
_XXXXXXXXXXXX_XXXXXXXXXXXXXXXX_XXXXXXXXXXXX_XXXXXX_
_XXXXXXXXXXXX_XXXXXXXXXXXXXXXX_XXXXXXXXXXXX_XXXXXX_
_XXXXXXXXXXXX_______XXXXXXXXXX___XXXXXXXXXX_XXXXXX_
_XXXXXXXXXXXX_XXXXX_XXXXXXXXXXXX_XXXXXXXXXX_XXXXXX_
_XXXXXXXXXXXX_XXXXX_XXXXXXXXXXXX_XXXXXXXXXX_XXXXXX_
_XXXXXXXXXXXX_XXXXX_XXXXXXXXXXXX_XXXXXXXXXX_XXXXXX_
___________________________________________________
_XXXXXXXXXXXX_XXXXXXXXXXXX_XXX_XXXXXXXXXXXX_XXXXXX_
_XXXXXXXXXXXX_XXXXXXXXXXXX_XXX_XXXXXXXXXXXX_XXXXXX_
_XXXXXXXXXXXX_XXXXXXXXXXXX_XXX_XXXXXXXXXXXX_XXXXXX_
_XXXXXXXXXXXX_XXXXXXXXXXXX_XXX_XXXXXXXXXXXX_XXXXXX_
_______________________________XXXXXXXXXXXX_XXXXXX_
_XXXXXXXXXXXX_XXXXXXXXXXXXXXXX_XXXXXXXXXXXX_XXXXXX_
_XXXXXXXXXXXX_XXXXXXXXXXXXXXXX_XXXXXXXXXXXX_XXXXXX_
_XXXXXXXXXXXX_XXXXXXXXXXXXXXXX_XXXXXXXXXXXX_XXXXXX_
_XXXXXXXXXXXX_XXXXXXXXXXXXXXXX_XXXXXXXXXXXX_XXXXXX_
_XXXXXXXXXXXX_______XXXXXXXXXX___XXXXXXXXXX_XXXXXX_
_XXXXXXXXXXXXXXXXXX_XXXXXXXXXXXX_XXXXXXXXXX_XXXXXX_
_XXXXXXXXXXXXXXXXXX_XXXXXXXXXXXX_XXXXXXXXXX_XXXXXX_
_XXXXXXXXXXXXXXXXXX_XXXXXXXXXXXX_XXXXXXXXXX_XXXXXX_
___________________________________________________
_XXXXXXXXXXXX_XXXXXXXXXXXX_XXX_XXXXXXXXXXXX_XXXXXX_
_XXXXXXXXXXXX_XXXXXXXXXXXX_XXX_XXXXXXXXXXXX_XXXXXX_
_XXXXXXXXXXXX_XXXXXXXXXXXX_XXX_XXXXXXXXXXXX_XXXXXX_
_XXXXXXXXXXXX_XXXXXXXXXXXX_XXX_XXXXXXXXXXXX_XXXXXX_
_______________________________XXXXXXXXXXXX_XXXXXX_
_XXXXXXXXXXXX_XXXXXXXXXXXXXXXX_XXXXXXXXXXXX_XXXXXX_
_XXXXXXXXXXXX_XXXXXXXXXXXXXXXX_XXXXXXXXXXXX_XXXXXX_
_XXXXXXXXXXXX_XXXXXXXXXXXXXXXX_XXXXXXXXXXXX_XXXXXX_
_XXXXXXXXXXXX_XXXXXXXXXXXXXXXX_XXXXXXXXXXXX_XXXXXX_
___________________________________________________
_XXXXXXXXXXXXXXXXXX_XXXXXXXXXXXX_XXXXXXXXXX_XXXXXX_
_XXXXXXXXXXXXXXXXXX_XXXXXXXXXXXX_XXXXXXXXXX_XXXXXX_
_XXXXXXXXXXXXXXXXXX_XXXXXXXXXXXX_XXXXXXXXXX_XXXXXX_
_XXXXXXXXXXXXXXXXXX_XXXXXXXXXXXX_XXXXXXXXXX_XXXXXX_
___________________________________________________
_XXXXXXXXXXXX_XXXXXXXXXXXX_XXX_XXXXXXXXXXXX_XXXXXX_
_XXXXXXXXXXXX_XXXXXXXXXXXX_XXX_XXXXXXXXXXXX_XXXXXX_
___________________________________________________