.................................................. 
.____________.____________.___.____________._____.
.____________.____________.___.____________._____.
.____________.____________.___.____________._____.
...............................____________._____.
.____________.________________.____________._____.
.____________.________________.____________._____.
.____________.________________.____________._____.
.____________.________________.____________._____.
..................................................
.__________________.____________.__________._____.
.__________________.____________.__________._____.
.__________________.____________.__________._____.
.__________________.____________.__________._____.
..................................................
.____________.____________.___.____________._____.
.____________.____________.___.____________._____.
.____________.____________.___.____________._____.
.____________.____________.___.____________._____.
...............................____________._____.
.____________.________________.____________._____.
.____________.________________.____________._____.
.____________.________________.____________._____.
.____________.________________.____________._____.
..................................................
.__________________.____________.__________._____.
.__________________.____________.__________._____.
.__________________.____________.__________._____.
.__________________.____________.__________._____.
..................................................
.____________.____________.___.____________._____.
.____________.____________.___.____________._____.
.____________.____________.___.____________._____.
.____________.____________.___.____________._____.
...............................____________._____.
.____________.________________.____________._____.
.____________.________________.____________._____.
.____________.________________.____________._____.
.____________.________________.____________._____.
..................................................
.__________________.____________.__________._____.
.__________________.____________.__________._____.
.__________________.____________.__________._____.
.__________________.____________.__________._____.
..................................................
.____________.____________.___.____________._____.
.____________.____________.___.____________._____.
..................................................                                               